333333333333333333333333333
311111111111133111111111113
313333133333133133331333313
323333133333133133331333323
313333133333133133331333313
311111111111111111111111113
313333131333333333131333313
313333131111333111131333313
311111133330333033331111113
333333133330333033331333333
000003133330333033331300000
000003133300000003331300000
000003133303343303331300000
333333133303000303331333333
000000100003000300001000000
333333133303000303331333333
000003133303333303331300000
000003133300000003331300000
000003133303333303331300000
333333133303333303331333333
311111111111131111111111113
323333133033131331331333323
313333133033131331331333313
311133133133131331331331113
333133133111131111331331333
311111133333131333331111113
313333333333131333333333313
311111111111111111111111113
333333333333333333333333333